xxxxxxxxxxxxxxxx
x     x       sx
x xxx x xx x   x
x xs  x vx svx x
x xxxxx  xxxx  x
x  x  vx xxx  xx
xx x  sx vxx xsx
xv x xxx   x   x
x    v   x sx vx
x xxxv x xxxx xx
xs     x sxvs fx
xxxxxxxxxxxxxxxx
